{
    "0": 31,
    "8": 30,
    "9": 36,
    "10": 27,
    "16": 29,
    "17": 25,
    "18": 21,
    "19": 22,
    "20": 23,
    "24": 28,
    "25": 24,
    "26": 20,
    "27": 16,
    "28": 17,
    "29": 18,
    "30": 19,
    
    "32": 3,
    "33": 2,
    "34": 1,
    "35": 0,
    "36": 32,
    "37": 36,
    "38": 40,
    "39": 44,
    
    "40": 7,
    "41": 6,
    "42": 5,
    "43": 4,
    "44": 33,
    "45": 37,
    "46": 41,
    "47": 45,
    
    "48": 11,
    "49": 10,
    "50": 9,
    "51": 8,
    "52": 34,
    "53": 38,
    "54": 42,
    "55": 46,
    
    "56": 15,
    "57": 14,
    "58": 13,
    "59": 12,
    "60": 35,
    "61": 39,
    "62": 43,
    "63": 47
}